NO ./textures/color_stone.xpm
SO ./textures/eagle.xpm
WE ./textures/wood.xpm
EA ./textures/grey_stone.xpm

F 255,0,0
C 0,100,0

1111111111
1E00000001
1111111111
