NO ./textures/color_stone.xpm
SO ./textures/eagle.xpm
WE ./textures/wood.xpm
EA ./textures/grey_stone.xpm

F 255,0,0
C 0,100,0

11111111111111111111
1000000000S000000001
10111111111111111101
10111111111111111101
10111111111111111101
10111111111111111101
10111111111111111101
10111111111111111101
10111111111111111101
10000000000000000001
11111111111111111111
