NO ./textures/color_stone.xpm
SO ./textures/wood.xpm
WE ./textures/eagle.xpm
EA ./textures/grey_stone.xpm

F 255,0,0
C 0,100,0

11111111111111111111
10000000000000000001
10000000000000000001
10000000000000000001
10000000000000000001
100000000W0000000001
10000000000000000001
10000000000000000001
10000000000000000001
11111111111111111111
